mapID,DoorType,doorID,LinkStage
1,L,011,2
1,U,012,3
2,L,021,4
2,U,022,5
2,R,023,1
3,L,031,5
3,U,032,6
3,D,034,1
4,U,042,7
4,R,043,2
5,L,051,7
5,U,052,8
5,R,053,3
5,D,054,2
6,L,061,8
6,D,064,3
7,U,072,9
7,R,073,5
7,D,074,4
8,L,081,9
8,U,082,10
8,R,083,6
8,D,084,5
9,R,093,8
9,D,094,7
10,D,101,8
